10 9
5 3 8 6 9 1 7 4 2 
3 8 6 9 1 7 4 2 9 
8 6 9 1 7 4 2 0 2 
6 9 1 7 4 2 0 2 7 
9 1 7 4 2 0 2 7 4 
1 7 4 2 0 2 7 4 1 
7 4 2 0 2 7 4 1 3 
4 2 0 2 7 4 1 3 5 
2 0 2 7 4 1 3 5 8 
0 2 7 4 1 3 5 8 84