10 15 31
-8 1 4 0 0 6 -6 -10 -3 0 -2 -1 -2 0 11
10 5 5 1 7 4 9 10 0 -7 -5 0 -9 7 12
4 10 -7 4 8 0 12 0 -1 -4 8 -9 -2 5 -1
6 6 4 -9 0 0 12 10 -4 3 12 11 4 -4 -8
-4 0 0 -10 7 0 -1 -11 1 8 0 11 0 -11 -1
4 11 -9 1 -8 6 -4 -1 0 5 -7 -6 0 14 -5
7 0 5 -10 11 9 2 1 -4 5 12 0 -10 7 10
2 2 6 9 -5 -1 13 -3 -6 4 -11 13 10 3 -6
3 7 14 -4 -4 9 2 5 0 4 -11 12 -1 9 -2
1 -10 -8 1 -6 -4 9 11 5 -4 -4 7 2 12 87