20 20
3 7 5 2 9 4 8 6 1 3 3 4 7 9 6 2 5 8 1 3
6 1 9 4 3 7 5 2 8 6 6 1 9 4 3 7 5 2 8 6
8 0 5 7 1 9 3 4 6 8 8 2 5 7 1 9 3 0 6 8
1 4 6 8 2 5 7 9 3 1 1 4 6 8 2 5 7 9 3 1
4 9 3 1 6 0 2 5 7 4 4 9 0 1 6 8 2 5 7 4
5 8 0 6 7 1 0 3 4 5 5 8 2 6 7 1 9 3 4 0
0 3 4 0 5 2 6 8 1 7 7 3 4 9 5 2 6 8 1 7
9 6 1 3 8 4 7 5 2 9 9 6 1 3 8 4 7 5 2 9
2 5 7 4 1 6 3 9 8 2 2 5 7 4 1 0 3 9 8 2
3 7 5 2 9 4 8 6 1 3 3 4 7 9 6 2 5 8 1 3
6 1 9 4 3 7 5 2 8 6 6 1 9 4 3 7 5 2 0 6
8 2 0 7 1 9 3 4 6 8 8 2 5 7 1 9 0 4 6 8
1 4 6 8 2 5 7 9 3 1 1 4 6 8 2 5 7 9 3 1
4 9 3 1 6 8 2 5 7 4 4 9 3 1 6 8 2 5 7 0
5 8 2 6 7 1 9 3 4 5 5 0 2 6 7 1 9 3 4 5
7 3 4 9 5 2 6 8 1 7 7 3 4 9 5 2 6 8 1 7
9 0 0 0 8 4 7 5 2 9 9 6 1 3 8 4 0 5 2 9
2 5 7 4 1 6 3 9 8 2 2 5 7 4 1 6 3 9 8 2
3 7 5 2 9 4 8 6 0 3 3 4 7 9 6 2 5 8 1 3
6 1 9 4 3 7 5 2 8 6 6 1 9 4 3 3 5 2 8 6
