12 12
-21 -16   0 -17   3 -13 -28 -13  25 -26 -21 -29 
-21 -11  -2 -26  -4 -24  23 -14  16   6 -14  25 
-31  -5   0   0 -23  24 -12  13   0   0  29   0 
 -6 -14  -4  25 -13   7 -29 -19 -10 -14   2   0 
-13   1  29  15  -8 -27   9  19  23   9  -2  -1 
  5 -20 -25   0   0  26 -30  28 -11   0  27  -8 
-12 -18   9   0 -26   0  13  15  -5 -29  23  23 
  0  16   0  23   0  -9 -17   9  12   0   9   0 
  9   0   0  -2 -21   0  25   0  24 -12 -23 -25 
 -5  22   0 -28  11 -18   5  -1 -22  -2  22  -9 
-17 -12  22   6 -27  16 -21   1 -13  26  28 -25 
-24  20  -3   0  25 -22  28   0  11   3 -18 -90 
