5 5
 1  3 -4  2  3 
 3 -2 -3  1 -4 
-4  1 -2  2  3 
 3  2  0 -3  3 
 2  2  3  1  2 
